NO    ./path_to_the_north_texture
WE     ./path_to_the_west_texture
SO ./path_to_the_south_texture  
F 220,100,0
C 225,30,0
EA ./path_to_the_east_texture

    111111
  10   0101
   101001
   
     1100N1
    1111   11

