NO    ./path_to_the_north_texture
WE     ./path_to_the_west_texture
SO ./path_to_the_south_texture  
EA ./path_to_the_east_texture
C    225, 30,0
F 221,100,0     
   
    111111
  10   0101
   101001
   
     1100N1
    1111   11
