NO ./textures/n.xpm
SO ./textures/s.xpm
WE ./textures/w.xpm
EA ./textures/e.xpm

F 236,211,159
C 85,90,130

11111
10001
10001
10001
10001
10001
11W01
10001
10001
10001
10001
10001
11111