NO    ./textures/wall_n.xpm
WE     ./textures/wall_w.xpm
SO ./textures/wall_s.xpm  
EA ./textures/wall_e.xpm

C 225,0,0
  F 221,100,0
 

 

       11    1   1    11
  111111     11111     111111
 1000001     10001     1000001
10000001    1100011    10000001
1000000111111000001111110000001
1000000000000000000000000000001
1000011100011000001100011100001
100001 11011 10001 11011 100001
 1001    1    1S1    1    1001
  111          1          111
    1                     1






