NO textures/north.xpm
SO textures/south.xpm
WE textures/west.xpm
EA textures/east.xpm

F 20,20,20
C 200,200,200

11111
00011
111S1
10001
10101
11 11


11111
00 11
11101
10001
10101
11 11