NO textures/north.xpm
SO textures/south.xpm
WE textures/west.xpm
EA textures/east.xpm

E1 textures/game/enemy.xpm

D textures/game/door.xpm

F 236, 211, 159
C 85, 90, 130

11111
10001
10S01
10001
10001
11101
11D01
10111
10001
10001
10001
10X01
11111