NO    ./textures/doom_01.xpm
WE     ./textures/doom_01.xpm
SO      ./textures/doom_01.xpm
EA      ./textures/doom_face.xpm

C 126,144,148
F 44,51,7

1111111
1000011
1000001
1001001
1000001
100N001
1111111
